[ {
    "walls": [
    ["-","-","-","-","-","-","-","-","-","-","-","-","-","-","-","-","-","-","-","-","-"],
    ["-","-","-","-","-","-","-","-","-","-","-","-","-","-","-","-","-","-","-","-","-"],
    ["-","-","-","-","-","-","-","-","-","-","-","-","-","-","-","-","-","-","-","-","-"],
    ["-","-","-","-","-","-","-","-","-","-","-","-","-","-","-","-","-","-","-","-","-"],
    ["-","-","-","-","-","-","-","-","-","-","-","-","-","-","-","-","-","-","-","-","-"],
    ["-","-","-","-","-","-","-","-","-","-","-","-","-","-","-","-","-","-","-","-","-"],
    ["-","-","-","-","-","-","-","-","-","-","-","-","-","-","-","-","-","-","-","-","-"],
    ["-","-","-","-","-","-","-","-","c","c","c","-","-","-","-","-","-","-","-","-","-"],
    ["-","-","-","-","-","-","-","-","c","p","c","-","-","-","-","-","-","-","-","-","-"],
    ["-","-","-","-","-","-","-","-","c","c","c","-","-","-","-","-","-","-","-","-","-"],
    ["-","-","-","-","-","-","-","-","-","-","-","-","-","-","-","-","-","-","-","-","-"],
    ["-","-","-","-","-","-","-","-","-","-","-","-","-","-","-","-","-","-","-","-","-"]
  ],
  "level_name": "Tutorial 0:press 'a' or 'd' to select\nand press 'space' to aplay",
  "type_name": ["",""],
  "type_count": [1,1],
  "biom": "-"
},
  {
    "walls": [
    ["w","w","w","w","w","w","w","w","w","w","w","w","w","w","w","w","w","w","w","w","w"],
    ["w","-","-","-","-","-","-","-","-","-","-","-","-","-","-","-","-","-","-","-","w"],
    ["w","-","-","-","-","-","-","-","-","-","-","-","-","-","-","-","-","-","-","-","w"],
    ["w","-","-","-","-","-","-","-","-","-","-","-","-","-","-","-","-","-","-","-","w"],
    ["w","-","-","-","-","-","-","-","-","-","-","-","-","-","-","-","-","-","-","-","w"],
    ["w","-","-","-","-","-","-","-","-","-","-","-","-","-","-","-","-","-","-","-","w"],
    ["w","-","-","-","-","-","-","-","-","-","-","-","-","-","-","-","-","-","-","-","w"],
    ["w","-","-","-","-","-","-","-","-","-","c","-","-","-","-","-","-","-","-","-","w"],
    ["w","-","-","-","-","-","-","-","-","v","v","-","-","-","-","-","-","-","-","-","w"],
    ["w","-","-","-","-","v","v","-","-","-","-","-","-","-","-","-","-","-","-","-","w"],
    ["w","p","-","-","v","w","w","-","-","-","-","-","-","-","-","-","-","-","-","-","w"],
    ["w","v","v","v","w","w","w","v","v","v","v","v","v","v","v","v","v","v","v","v","w"]
  ],
  "level_name": "Tutorial 1:Move AD, Jump W, restart level R",
  "type_name": ["stone",""],
  "type_count": [1],
  "biom": "grass"
},
{
  "walls": [
  ["w","w","w","w","w","w","w","w","w","w","w","w","w","w","w","w","w","w","w","w","w"],
  ["w","-","-","-","-","-","-","-","-","-","-","-","-","-","-","-","-","-","-","-","w"],
  ["w","-","-","-","-","-","-","-","-","-","-","-","-","-","-","-","-","-","-","-","w"],
  ["w","-","-","-","-","-","-","-","-","-","-","-","-","-","-","-","-","-","-","-","w"],
  ["w","-","-","-","-","-","-","-","-","-","-","c","-","-","-","-","-","-","-","-","w"],
  ["w","-","-","-","-","-","-","-","-","-","v","v","v","-","-","v","v","v","-","-","w"],
  ["w","-","-","-","-","-","-","-","-","-","-","-","-","-","-","-","-","-","-","v","w"],
  ["w","-","-","-","-","-","-","-","-","-","-","-","-","-","-","-","-","-","-","w","w"],
  ["w","-","-","-","-","-","-","-","-","-","-","-","-","-","v","-","-","v","v","w","w"],
  ["w","-","-","-","-","v","v","-","-","-","-","-","-","v","w","-","-","w","w","w","w"],
  ["w","p","-","-","-","w","w","-","-","-","-","-","v","w","w","v","v","w","w","w","w"],
  ["w","v","v","v","v","w","w","v","v","v","v","v","w","w","w","w","w","w","w","w","w"]
],
"level_name": "Tutorial 2:Deactiavate Golem: Z",
"type_name": ["stone",""],
"type_count": [2,1],
"biom": "grass"
},
{
  "walls": [
  ["w","w","w","w","w","w","w","w","w","w","w","w","w","w","w","w","w","w","w","w","w"],
  ["w","-","-","-","-","-","-","-","-","-","-","-","-","-","-","-","-","-","-","-","w"],
  ["w","-","-","-","-","-","-","-","-","-","-","-","-","-","-","-","-","-","-","-","w"],
  ["w","-","-","-","-","-","c","-","-","-","-","-","-","-","-","-","-","-","-","-","w"],
  ["w","-","-","-","-","-","v","v","v","-","v","-","-","-","-","-","-","-","-","-","w"],
  ["w","-","-","-","-","-","-","-","-","-","-","-","v","-","-","-","v","-","-","-","w"],
  ["w","-","-","-","-","-","-","-","-","-","-","-","-","-","-","-","-","-","-","v","w"],
  ["w","-","-","-","-","-","-","-","-","-","-","-","-","-","-","-","-","-","v","w","w"],
  ["w","-","-","-","-","-","-","-","-","-","-","-","-","-","-","v","v","v","w","w","w"],
  ["w","-","-","-","-","v","l","l","l","l","v","-","-","v","v","w","w","w","w","w","w"],
  ["w","p","-","-","v","w","w","w","w","w","w","v","v","w","w","w","w","w","w","w","w"],
  ["w","v","v","v","w","w","w","w","w","w","w","w","w","w","w","w","w","w","w","w","w"]
],
"level_name": "Tutorial 3:Metal Golem can swimming in lava",
"type_name": ["metal","wood"],
"type_count": [2,1],
"biom": "stone"
},
{
  "walls": [
  ["w","w","w","w","w","w","w","w","w","w","w","w","w","w","w","w","w","w","w","w","w"],
  ["w","-","-","-","-","-","-","-","-","-","-","-","-","-","-","-","-","-","-","-","w"],
  ["w","-","-","-","-","-","-","-","-","-","-","-","-","-","-","-","-","-","-","-","w"],
  ["w","-","-","-","-","-","-","-","-","-","-","-","-","-","-","-","-","-","-","-","w"],
  ["w","p","-","-","-","-","-","-","-","-","-","-","-","-","-","-","-","-","-","-","w"],
  ["w","v","v","-","-","-","-","-","-","-","-","-","-","-","-","-","-","-","-","-","w"],
  ["w","w","w","l","l","v","-","-","-","-","-","-","-","-","-","-","-","-","-","v","w"],
  ["w","w","w","l","l","w","-","-","-","-","-","-","-","-","-","-","-","-","-","w","w"],
  ["w","w","w","l","l","w","-","-","-","-","-","-","-","-","v","-","-","v","v","w","w"],
  ["w","w","w","l","l","w","v","v","v","v","-","-","-","v","w","-","-","w","w","w","w"],
  ["w","w","w","l","l","-","-","-","c","w","-","-","v","w","w","v","v","w","w","w","w"],
  ["w","w","w","w","w","w","w","w","w","w","v","v","w","w","w","w","w","w","w","w","w"]
],
"level_name": "Tutorial 4:Lava Golem drowning in lava",
"type_name": ["stone","metal"],
"type_count": [1,1],
"biom": "stone"
},
{
  "walls": [
  ["w","w","w","w","w","w","w","w","w","w","w","w","w","w","w","w","w","w","w","w","w"],
  ["w","-","-","-","-","-","-","-","-","-","-","-","-","-","-","-","-","-","-","-","w"],
  ["w","-","-","-","-","-","-","-","-","-","-","-","-","-","-","-","-","-","-","-","w"],
  ["w","-","-","-","-","-","-","-","-","-","-","-","-","-","-","-","-","-","-","-","w"],
  ["w","-","-","-","-","-","-","-","-","-","-","-","-","-","-","-","-","-","-","-","w"],
  ["w","-","-","-","-","-","-","-","-","-","-","-","-","-","-","-","-","-","-","-","w"],
  ["w","-","-","-","-","-","-","-","-","-","-","-","-","-","-","-","-","-","-","-","w"],
  ["w","-","-","-","-","-","-","-","-","-","-","-","-","-","-","-","-","-","-","-","w"],
  ["w","-","-","-","-","-","-","-","-","-","-","-","-","-","-","-","-","-","-","-","w"],
  ["w","-","-","-","-","-","-","-","-","-","-","-","-","c","-","-","-","-","-","-","w"],
  ["w","-","p","-","v","l","l","l","l","l","l","v","-","-","-","-","-","-","-","-","w"],
  ["w","v","v","v","w","w","w","w","w","w","w","w","v","v","v","v","v","v","v","v","w"]
],
"level_name": "Tutorial 5:Other Golems die in lava",
"type_name": ["metal","portal"],
"type_count": [1,1],
"biom": "stone"
},
{
  "walls": [
  ["w","w","w","w","w","w","w","w","w","w","w","w","w","w","w","w","w","w","w","w","w"],
  ["w","-","-","-","-","-","-","-","-","-","-","-","-","-","-","-","-","-","-","-","w"],
  ["w","-","-","-","-","-","-","-","-","-","-","-","-","o","-","-","-","-","-","-","w"],
  ["w","-","-","-","-","-","-","-","-","-","-","-","v","v","v","-","-","-","-","-","w"],
  ["w","p","-","-","-","-","-","-","-","-","-","-","-","-","-","-","-","-","-","-","w"],
  ["w","v","v","-","-","-","-","-","-","-","-","-","-","-","-","-","-","-","-","-","w"],
  ["w","w","w","-","-","-","-","-","-","-","-","-","-","-","-","-","-","-","-","v","w"],
  ["w","w","w","-","-","-","-","-","-","i","-","-","-","v","-","-","-","-","c","w","w"],
  ["w","w","w","-","-","-","-","-","v","v","-","-","-","w","v","-","-","-","v","w","w"],
  ["w","w","w","-","-","-","v","-","-","-","-","-","-","w","w","-","-","v","w","w","w"],
  ["w","w","w","l","l","l","w","l","l","l","l","l","l","w","w","l","l","w","w","w","w"],
  ["w","w","w","w","w","w","w","w","w","w","w","w","w","w","w","w","w","w","w","w","w"]
],
"level_name": "Tutorial 6:Portal Golem can see portals",
"type_name": ["stone","portal"],
"type_count": [1,1],
"biom": "stone"
},
{
  "walls": [
  ["w","w","w","w","w","w","w","w","w","w","w","w","w","w","w","w","w","w","w","w","w"],
  ["w","-","-","-","-","-","-","-","-","-","-","-","-","-","-","-","-","-","-","-","w"],
  ["w","-","-","-","-","-","-","-","-","-","-","-","-","-","-","-","-","-","-","-","w"],
  ["w","-","-","-","-","-","-","-","-","-","-","-","-","-","-","-","-","-","-","-","w"],
  ["w","-","-","-","-","-","-","-","-","-","-","-","-","-","-","-","-","-","-","-","w"],
  ["w","-","-","-","-","-","-","-","-","-","-","-","-","-","-","-","-","-","-","-","w"],
  ["w","-","-","-","-","-","-","-","-","-","-","-","-","-","-","-","-","-","-","-","w"],
  ["w","-","-","-","-","-","-","-","-","-","-","-","-","-","-","-","-","-","-","-","w"],
  ["w","-","-","-","-","v","v","-","-","-","-","-","-","-","-","-","-","-","-","-","w"],
  ["w","p","-","-","-","-","-","-","-","-","-","-","c","-","-","-","-","-","-","-","w"],
  ["w","v","v","l","l","w","w","h","h","h","h","v","v","-","-","-","-","-","-","-","w"],
  ["w","w","w","w","w","w","w","w","w","w","w","w","w","w","w","w","w","w","w","w","w"]
],
"level_name": "Tutorial 7:Metal Golems die in water \nPortal Golem can swimming in water",
"type_name": ["portal","metal"],
"type_count": [1,1],
"biom": "stone"
},
{
  "walls": [
  ["w","w","w","w","w","w","w","w","w","w","w","w","w","w","w","w","w","w","w","w","w"],
  ["w","-","-","-","-","-","-","-","-","-","-","-","-","-","-","-","-","-","-","-","w"],
  ["w","-","-","-","v","v","v","v","v","v","v","-","-","-","-","-","-","-","-","-","w"],
  ["w","-","v","-","-","-","-","-","-","-","w","-","-","-","c","v","v","-","-","-","w"],
  ["w","-","w","v","v","v","-","-","-","-","w","-","-","-","v","-","-","-","v","-","w"],
  ["w","-","-","-","-","w","v","v","-","-","w","-","-","-","-","-","-","v","w","-","w"],
  ["w","-","-","-","-","-","-","-","-","v","w","-","-","-","-","-","v","w","-","-","w"],
  ["w","-","-","-","-","-","-","-","v","w","-","v","-","-","-","v","w","-","-","-","w"],
  ["w","-","-","-","-","-","-","v","w","-","-","-","-","-","-","-","-","-","-","-","w"],
  ["w","-","-","-","-","v","-","-","-","-","-","-","-","v","-","-","-","-","-","-","w"],
  ["w","-","p","-","v","w","-","-","-","-","-","-","-","w","-","-","-","-","-","-","w"],
  ["w","v","v","v","v","v","v","v","v","v","v","v","v","w","v","v","v","v","v","v","w"]
],
"level_name": "Tutorial completed",
"type_name": ["metal"],
"type_count": [2],
"biom": "grass"
},
{
  "walls": [
  ["w","w","w","w","w","w","w","w","w","w","w","w","w","w","w","w","w","w","w","w","w"],
  ["w","-","-","-","-","-","-","-","-","-","-","-","-","-","-","-","-","-","-","-","w"],
  ["w","-","-","-","-","-","-","-","-","-","-","-","-","-","-","-","-","-","-","-","w"],
  ["w","-","-","-","-","-","-","-","-","-","-","-","-","-","-","-","-","-","-","-","w"],
  ["w","-","-","-","-","-","-","-","-","-","-","c","-","-","-","-","-","-","-","-","w"],
  ["w","-","-","-","-","-","-","-","-","-","-","v","-","-","-","-","-","-","-","-","w"],
  ["w","-","-","-","-","-","-","-","-","-","-","w","-","-","-","-","-","-","-","-","w"],
  ["w","-","-","-","-","-","-","-","-","-","-","w","-","-","-","-","-","-","-","-","w"],
  ["w","-","-","-","-","-","-","-","-","-","-","w","-","-","-","-","-","-","-","-","w"],
  ["w","-","-","-","-","-","-","-","-","-","-","w","-","-","-","-","-","-","-","-","w"],
  ["w","-","p","-","-","-","-","-","-","-","-","w","-","-","-","-","-","-","-","-","w"],
  ["w","v","v","v","v","v","v","v","v","v","v","w","v","v","v","v","v","v","v","v","w"]
],
"level_name": "1",
"type_name": ["stone"],
"type_count": [6],
"biom": "grass"
},
{
  "walls": [
  ["w","w","w","w","w","w","w","w","w","w","w","w","w","w","w","w","w","w","w","w","w"],
  ["w","-","-","-","-","-","-","-","-","-","-","-","-","-","-","-","-","-","-","-","w"],
  ["w","-","-","-","-","-","-","-","-","-","-","-","-","-","-","-","-","-","-","-","w"],
  ["w","-","-","-","-","-","-","-","-","-","-","-","-","-","-","-","-","-","-","-","w"],
  ["w","-","-","-","-","-","-","-","-","-","-","-","-","-","-","-","-","-","-","-","w"],
  ["w","-","-","-","-","-","-","-","-","-","-","-","-","-","-","-","-","-","-","-","w"],
  ["w","-","-","-","-","-","-","h","v","v","v","v","v","-","-","-","-","-","-","-","w"],
  ["w","-","-","-","-","-","-","h","w","-","-","-","-","-","-","-","-","-","-","-","w"],
  ["w","-","-","-","-","-","-","h","w","c","-","-","-","-","-","-","-","-","-","-","w"],
  ["w","-","-","-","-","-","-","h","w","v","v","v","-","-","-","-","-","-","-","-","w"],
  ["w","-","p","-","-","-","-","h","w","w","w","w","-","-","-","-","-","-","-","-","w"],
  ["w","v","v","v","v","v","v","v","v","v","v","v","v","v","v","v","v","v","v","v","w"]
],
"level_name": "1",
"type_name": ["portal","metal"],
"type_count": [2,1],
"biom": "grass"
},
{
  "walls": [
  ["w","w","w","w","w","w","w","w","w","w","w","w","w","w","w","w","w","w","w","w","w"],
  ["w","-","-","-","-","-","-","-","-","-","-","-","-","-","-","-","-","-","-","-","w"],
  ["w","-","-","-","-","-","-","-","-","-","-","-","-","-","-","-","-","-","-","-","w"],
  ["w","-","-","-","-","-","-","-","-","-","-","-","-","-","-","-","-","-","-","-","w"],
  ["w","-","-","-","-","-","-","-","-","-","-","-","-","-","-","-","-","-","-","-","w"],
  ["w","-","-","-","-","-","-","-","-","-","-","-","-","-","-","-","-","-","-","-","w"],
  ["w","-","-","-","-","-","-","-","-","-","-","-","-","-","-","-","-","-","-","-","w"],
  ["w","-","-","-","-","-","-","-","-","-","-","-","-","-","-","-","-","-","-","-","w"],
  ["w","-","-","-","-","-","-","-","-","-","-","-","-","-","-","-","-","-","-","-","w"],
  ["w","-","-","-","-","-","-","-","-","-","-","-","-","-","-","-","-","-","-","-","w"],
  ["w","-","p","-","-","-","-","-","-","-","-","-","-","-","-","-","-","-","-","-","w"],
  ["w","v","v","v","v","v","v","v","v","v","v","v","v","v","v","v","v","v","v","v","w"]
],
"level_name": "1",
"type_name": ["portal","metal"],
"type_count": [1,2],
"biom": "grass"
},
{
  "walls": [
  ["w","w","w","w","w","w","w","w","w","w","w","w","w","w","w","w","w","w","w","w","w"],
  ["w","-","-","-","-","-","-","-","-","-","-","-","-","-","-","-","-","-","-","-","w"],
  ["w","-","-","-","-","-","-","-","-","-","-","-","-","-","-","-","-","-","-","-","w"],
  ["w","-","-","-","-","-","-","-","-","-","-","-","-","-","-","-","-","-","-","-","w"],
  ["w","-","-","-","-","-","-","-","-","-","-","-","-","-","-","-","-","-","-","-","w"],
  ["w","-","-","-","-","-","-","-","-","-","-","-","-","-","-","-","-","-","-","-","w"],
  ["w","-","-","-","-","-","-","-","-","-","-","-","-","-","-","-","-","-","-","-","w"],
  ["w","-","-","-","-","-","-","-","-","-","-","-","-","-","-","-","-","-","-","-","w"],
  ["w","-","-","-","-","-","-","-","-","-","-","-","-","-","-","-","-","-","-","-","w"],
  ["w","-","-","-","-","-","-","-","-","-","-","-","-","-","-","-","-","-","-","-","w"],
  ["w","-","p","-","-","-","-","-","-","-","-","-","-","-","-","-","-","-","-","-","w"],
  ["w","v","v","v","v","v","v","v","v","v","v","v","v","v","v","v","v","v","v","v","w"]
],
"level_name": "1",
"type_name": ["portal","metal"],
"type_count": [1,2],
"biom": "grass"
},
{
  "walls": [
  ["w","w","w","w","w","w","w","w","w","w","w","w","w","w","w","w","w","w","w","w","w"],
  ["w","-","-","-","-","-","-","-","-","-","-","-","-","-","-","-","-","-","-","-","w"],
  ["w","-","-","-","-","-","-","-","-","-","-","-","-","-","-","-","-","-","-","-","w"],
  ["w","-","-","-","-","-","-","-","-","-","-","-","-","-","-","-","-","-","-","-","w"],
  ["w","-","-","-","-","-","-","-","-","-","-","-","-","-","-","-","-","-","-","-","w"],
  ["w","-","-","-","-","-","-","-","-","-","-","-","-","-","-","-","-","-","-","-","w"],
  ["w","-","-","-","-","-","-","-","-","-","-","-","-","-","-","-","-","-","-","-","w"],
  ["w","-","-","-","-","-","-","-","-","-","-","-","-","-","-","-","-","-","-","-","w"],
  ["w","-","-","-","-","-","-","-","-","-","-","-","-","-","-","-","-","-","-","-","w"],
  ["w","-","-","-","-","-","-","-","-","-","-","-","-","-","-","-","-","-","-","-","w"],
  ["w","-","p","-","-","-","-","-","-","-","-","-","-","-","-","-","-","-","-","-","w"],
  ["w","v","v","v","v","v","v","v","v","v","v","v","v","v","v","v","v","v","v","v","w"]
],
"level_name": "1",
"type_name": ["portal","metal"],
"type_count": [1,2],
"biom": "grass"
},
{
  "walls": [
  ["w","w","w","w","w","w","w","w","w","w","w","w","w","w","w","w","w","w","w","w","w"],
  ["w","-","-","-","-","-","-","-","-","-","-","-","-","-","-","-","-","-","-","-","w"],
  ["w","-","-","-","-","-","-","-","-","-","-","-","-","-","-","-","-","-","-","-","w"],
  ["w","-","-","-","-","-","-","-","-","-","-","-","-","-","-","-","-","-","-","-","w"],
  ["w","-","-","-","-","-","-","-","-","-","-","-","-","-","-","-","-","-","-","-","w"],
  ["w","-","-","-","-","-","-","-","-","-","-","-","-","-","-","-","-","-","-","-","w"],
  ["w","-","-","-","-","-","-","-","-","-","-","-","-","-","-","-","-","-","-","-","w"],
  ["w","-","-","-","-","-","-","-","-","-","-","-","-","-","-","-","-","-","-","-","w"],
  ["w","-","-","-","-","-","-","-","-","-","-","-","-","-","-","-","-","-","-","-","w"],
  ["w","-","-","-","-","-","-","-","-","-","-","-","-","-","-","-","-","-","-","-","w"],
  ["w","-","p","-","-","-","-","-","-","-","-","-","-","-","-","-","-","-","-","-","w"],
  ["w","v","v","v","v","v","v","v","v","v","v","v","v","v","v","v","v","v","v","v","w"]
],
"level_name": "1",
"type_name": ["portal","metal", "stone"],
"type_count": [1,2, 3],
"biom": "grass"
}
]
    





"w","w","w","w","w","w","w","w","w","w","w","w","w","w","w","w","w","w","w","w","w"
"w","-","-","-","-","-","-","-","-","-","-","-","-","-","-","-","-","-","-","-","w"
"w","-","-","-","-","-","-","-","-","-","-","-","-","-","-","-","-","-","-","-","w"
"w","-","-","-","-","-","-","-","-","-","-","-","-","-","-","-","-","-","-","-","w"
"w","p","-","-","-","-","-","-","-","-","-","-","-","-","-","-","-","-","-","-","w"
"w","v","v","-","-","-","-","-","-","-","-","-","-","-","-","-","-","-","-","-","w"
"w","w","w","-","-","-","-","-","-","v","v","v","v","v","-","-","-","-","-","v","w"
"w","w","w","-","-","-","-","-","-","-","l","l","l","w","-","-","-","-","c","w","w"
"w","w","w","-","-","-","l","l","l","-","l","l","l","w","v","-","-","-","v","w","w"
"w","w","w","-","-","-","l","l","l","v","l","l","l","w","w","-","-","v","w","w","w"
"w","w","w","v","-","-","l","l","l","w","l","l","l","-","-","-","-","w","w","w","w"
"w","w","w","w","v","v","w","w","w","w","v","v","w","w","w","w","w","w","w","w","w"

"w","w","w","w","w","w","w","w","w","w","w","w","w","w","w","w","w","w","w","w","w"
"w","-","-","-","-","-","-","-","-","-","-","-","-","-","-","-","-","-","-","-","w"
"w","-","-","-","-","-","-","-","-","-","-","-","-","-","-","-","-","-","-","-","w"
"w","-","-","-","-","-","-","-","-","-","-","-","-","-","-","-","-","-","-","-","w"
"w","-","-","-","-","-","-","-","-","-","-","-","-","-","-","-","-","-","-","-","w"
"w","-","-","-","-","-","-","-","-","-","-","-","-","-","-","-","-","-","-","-","w"
"w","-","-","-","-","-","-","-","-","-","-","-","-","-","-","-","-","-","-","-","w"
"w","-","-","-","-","-","-","-","-","-","-","-","-","-","-","-","-","-","-","-","w"
"w","-","-","-","-","-","-","-","-","-","-","-","-","-","-","-","-","-","-","-","w"
"w","-","-","-","-","-","-","-","-","-","-","-","-","-","-","-","-","-","-","-","w"
"w","-","p","-","-","-","-","-","-","-","-","-","-","-","-","-","-","-","-","-","w"
"w","v","v","v","v","v","v","v","v","v","v","v","v","v","v","v","v","v","v","v","w"

"w","w","w","w","w","w","w","w","w","w","w","w","w","w","w","w","w","w","w","w","w"
"w","-","-","-","-","-","-","-","-","-","-","-","-","-","-","-","-","-","-","w","w"
"w","-","-","-","-","-","-","-","-","-","-","-","c","-","-","-","-","-","-","w","w"
"w","-","-","-","-","-","-","-","-","-","-","-","v","v","v","-","-","v","h","w","w"
"w","-","-","-","-","-","-","-","-","-","-","-","-","-","-","-","-","w","h","w","w"
"w","-","-","-","-","-","-","-","-","-","-","-","-","-","-","-","-","w","h","w","w"
"w","p","-","-","-","-","-","-","-","-","-","-","-","-","-","-","-","w","h","w","w"
"w","v","v","-","-","-","-","-","-","-","-","-","-","-","-","-","-","w","h","w","w"
"w","w","-","-","-","v","v","-","-","-","-","-","-","-","-","-","-","-","h","w","w"
"w","w","-","-","-","w","w","-","-","-","-","-","-","-","-","-","-","v","h","w","w"
"w","w","h","h","h","w","w","v","h","h","v","v","v","v","v","l","l","w","w","w","w"
"w","w","w","w","w","w","w","w","w","w","w","w","w","w","w","w","w","w","w","w","w"