[ {
    "walls": [
    ["w","w","w","w","w","w","w","w","w","w","w","w","w","w","w","w","w","w","w","w","w"],
    ["w","-","-","-","-","-","-","-","-","-","-","-","-","-","-","-","-","-","-","-","w"],
    ["w","-","-","-","-","-","-","-","-","-","-","-","-","-","-","-","-","-","-","-","w"],
    ["w","-","-","-","-","-","-","-","-","-","v","v","v","v","-","-","v","-","-","-","w"],
    ["w","c","c","c","-","-","-","-","-","v","w","-","-","w","-","-","w","-","-","-","w"],
    ["w","c","p","c","-","-","-","-","v","w","-","-","-","w","-","-","w","-","-","-","w"],
    ["w","c","c","c","-","-","-","-","-","-","-","-","-","w","c","-","w","-","-","-","w"],
    ["w","-","-","-","-","-","-","v","v","-","-","-","-","w","v","v","w","-","-","-","w"],
    ["w","-","-","-","-","-","v","-","-","v","-","-","-","-","-","-","-","-","-","-","w"],
    ["w","-","-","-","c","v","v","-","-","-","v","-","-","-","-","-","-","-","-","-","w"],
    ["w","-","-","-","w","w","w","v","-","-","-","-","-","-","-","-","-","-","-","-","w"],
    ["w","w","w","w","w","w","w","w","w","w","w","w","w","w","w","w","w","w","w","w","w"]
  ],
  "level_name": "press 'a' or 'd' to select and press 'space' to aplay",
  "type_name": ["metal","wood","stone"],
  "type_count": [4,2,3],
  "biom": "lava"
},
  {
    "walls": [
    ["w","w","w","w","w","w","w","w","w","w","w","w","w","w","w","w","w","w","w","w","w"],
    ["w","-","-","-","-","-","-","-","-","-","-","-","-","-","-","-","-","-","-","-","w"],
    ["w","-","-","-","-","-","-","-","-","-","-","-","-","-","-","-","-","-","-","-","w"],
    ["w","-","-","-","-","-","-","-","-","-","-","-","-","-","-","-","-","-","-","-","w"],
    ["w","p","-","-","-","-","-","-","-","-","-","-","-","-","-","c","-","-","-","-","w"],
    ["w","v","v","v","-","-","-","-","-","-","-","-","-","v","v","v","-","-","-","-","w"],
    ["w","-","-","-","-","-","-","-","-","o","v","v","v","-","-","-","-","-","-","-","w"],
    ["w","-","-","-","-","-","-","v","v","v","-","-","-","-","-","-","-","-","-","-","w"],
    ["w","-","-","-","-","-","-","-","-","-","-","-","-","-","-","-","-","-","-","-","w"],
    ["w","-","-","-","-","-","-","-","-","-","-","-","-","-","-","-","-","-","-","-","w"],
    ["w","i","-","-","-","-","-","-","-","-","-","-","-","-","-","-","-","-","-","-","w"],
    ["w","w","w","w","w","w","w","w","w","w","w","w","w","w","w","w","w","w","w","w","w"]
  ],
  "level_name": "level2",
  "type_name": ["wood","metal","stone"],
  "type_count": [1,1,1],
  "biom": "grass"
},
  {
    "walls": [ 
    ["w","w","w","w","w","w","w","w","w","w","w","w","w","w","w","w","w","w","w","w","w"],
    ["w","-","-","-","-","-","-","-","-","-","-","-","-","-","-","-","-","-","-","-","w"],
    ["w","-","-","-","-","-","-","-","-","-","-","-","-","-","-","-","-","-","-","-","w"],
    ["w","-","-","-","-","-","-","-","-","-","-","-","-","-","-","-","-","-","-","-","w"],
    ["w","p","-","-","-","-","-","-","-","-","-","-","-","-","-","-","-","-","-","-","w"],
    ["w","v","v","v","-","-","-","-","-","-","-","-","-","-","-","-","-","-","-","-","w"],
    ["w","-","-","-","-","-","-","-","-","-","-","-","-","-","-","-","-","-","-","-","w"],
    ["w","-","-","-","-","-","-","-","-","-","-","-","-","-","-","-","-","-","-","-","w"],
    ["w","-","-","v","l","l","l","l","v","-","-","-","-","-","-","-","-","-","-","-","w"],
    ["w","-","-","w","l","l","l","l","w","-","-","-","-","-","-","-","-","-","-","-","w"],
    ["w","-","-","w","l","l","l","l","w","-","-","-","-","-","-","-","-","-","-","c","w"],
    ["w","w","w","w","w","w","w","w","w","w","w","w","w","w","w","w","w","w","w","w","w"]
    ],
    "level_name": "тут внизу типо лава",
    "type_name": ["wood","metal","stone"],
    "type_count": [0,2,1],
    "biom": "stone"
  },
  {
    "walls": [ 
    ["w","w","w","w","w","w","w","w","w","w","w","w","w","w","w","w","w","w","w","w","w"],
    ["w","-","-","-","-","-","-","-","-","-","-","-","-","-","-","-","-","-","-","-","w"],
    ["w","-","-","-","-","-","-","-","-","-","-","-","-","-","-","-","-","-","-","-","w"],
    ["w","-","-","-","-","-","-","-","-","-","-","-","-","-","-","-","-","-","-","-","w"],
    ["w","p","-","-","-","-","-","-","-","-","-","-","-","-","-","-","-","-","-","-","w"],
    ["w","v","v","v","-","-","-","-","-","-","-","-","-","-","-","-","-","-","-","-","w"],
    ["w","-","-","-","-","-","-","-","-","-","-","-","-","-","-","-","-","-","-","-","w"],
    ["w","-","-","-","-","-","-","-","-","-","-","-","-","-","-","-","-","-","-","-","w"],
    ["w","-","-","v","l","l","l","l","v","-","-","-","-","-","-","-","-","-","-","-","w"],
    ["w","-","-","w","l","l","l","l","w","-","-","-","-","-","-","-","-","-","-","-","w"],
    ["w","-","-","w","l","l","l","l","w","-","-","-","-","-","-","-","-","-","-","c","w"],
    ["w","w","w","w","w","w","w","w","w","w","w","w","w","w","w","w","w","w","w","w","w"]
    ],
    "level_name": "13616",
    "type_name": ["wood","metal","stone"],
    "type_count": [0,2,1],
    "biom": "stone"
  }
]
    