[ {
    "walls": [
    ["-","-","-","-","-","-","-","-","-","-","-","-","-","-","-","-","-","-","-","-","-"],
    ["-","-","-","-","-","-","-","-","-","-","-","-","-","-","-","-","-","-","-","-","-"],
    ["-","-","-","-","-","-","-","-","-","-","-","-","-","-","-","-","-","-","-","-","-"],
    ["-","-","-","-","-","-","-","-","-","-","-","-","-","-","-","-","-","-","-","-","-"],
    ["-","-","-","-","-","-","-","-","-","-","-","-","-","-","-","-","-","-","-","-","-"],
    ["-","-","-","-","-","-","-","-","-","-","-","-","-","-","-","-","-","-","-","-","-"],
    ["-","-","-","-","-","-","-","-","-","-","-","-","-","-","-","-","-","-","-","-","-"],
    ["-","-","-","-","-","-","-","-","c","c","c","-","-","-","-","-","-","-","-","-","-"],
    ["-","-","-","-","-","-","-","-","c","p","c","-","-","-","-","-","-","-","-","-","-"],
    ["-","-","-","-","-","-","-","-","c","c","c","-","-","-","-","-","-","-","-","-","-"],
    ["-","-","-","-","-","-","-","-","-","-","-","-","-","-","-","-","-","-","-","-","-"],
    ["-","-","-","-","-","-","-","-","-","-","-","-","-","-","-","-","-","-","-","-","-"]
  ],
  "level_name": "press 'a' or 'd' to select and press 'space' to aplay",
  "type_name": ["",""],
  "type_count": [1,1],
  "biom": "-"
},
  {
    "walls": [
    ["w","w","w","w","w","w","w","w","w","w","w","w","w","w","w","w","w","w","w","w","w"],
    ["w","-","-","-","-","-","-","-","-","-","-","-","-","-","-","-","-","-","-","-","w"],
    ["w","-","-","-","-","-","-","-","-","-","-","-","-","-","-","-","-","-","-","-","w"],
    ["w","-","-","-","-","-","-","-","-","-","-","-","-","-","-","-","-","-","-","-","w"],
    ["w","p","-","-","-","-","-","-","-","-","-","-","-","-","-","c","-","-","-","-","w"],
    ["w","v","v","v","-","-","-","-","-","-","-","-","-","v","v","v","-","-","-","-","w"],
    ["w","-","-","-","-","-","-","-","-","o","v","v","v","-","-","-","-","-","-","-","w"],
    ["w","-","-","-","-","-","-","v","v","v","-","-","-","-","-","-","-","-","-","-","w"],
    ["w","-","-","-","-","-","-","-","-","-","-","-","-","-","-","-","-","-","-","-","w"],
    ["w","-","-","-","-","-","-","-","-","-","-","-","-","-","-","-","-","-","-","-","w"],
    ["w","i","-","-","-","-","-","-","-","-","-","-","-","-","-","-","-","-","-","-","w"],
    ["w","w","w","w","w","w","w","w","w","w","w","w","w","w","w","w","w","w","w","w","w"]
  ],
  "level_name": "level2",
  "type_name": ["portal","metal","stone"],
  "type_count": [10,10,10],
  "biom": "grass"
},
  {
    "walls": [ 
    ["w","w","w","w","w","w","w","w","w","w","w","w","w","w","w","w","w","w","w","w","w"],
    ["w","-","-","-","-","-","-","-","-","-","-","-","-","-","-","-","-","-","-","-","w"],
    ["w","-","p","-","-","-","-","-","-","-","-","-","-","-","-","-","-","-","-","-","w"],
    ["w","v","v","v","-","-","-","-","-","-","-","-","-","-","-","-","-","-","-","-","w"],
    ["w","-","-","-","-","-","-","-","-","-","-","-","-","-","-","-","-","-","-","-","w"],
    ["w","-","-","-","-","-","-","-","-","-","-","-","-","-","-","-","-","-","-","-","w"],
    ["w","-","-","-","-","-","-","-","-","-","-","-","-","-","-","-","-","-","-","-","w"],
    ["w","-","-","-","-","-","-","-","-","-","-","-","l","l","-","-","-","-","-","-","w"],
    ["w","-","-","v","l","l","l","l","v","-","-","-","l","l","-","-","-","-","-","-","w"],
    ["w","-","-","w","l","l","l","l","-","v","v","-","l","l","-","-","-","-","-","-","w"],
    ["w","-","-","w","l","l","l","l","-","-","-","-","-","-","-","-","-","-","-","c","w"],
    ["w","w","w","w","w","w","w","w","w","w","w","w","w","w","w","w","w","w","w","w","w"]
    ],
    "level_name": "тут внизу типо лава",
    "type_name": ["portal","metal","stone"],
    "type_count": [2,2,1],
    "biom": "stone"
  },
  {
    "walls": [ 
    ["w","w","w","w","w","w","w","w","w","w","w","w","w","w","w","w","w","w","w","w","w"],
    ["w","-","-","-","-","-","-","-","-","-","-","-","-","-","-","-","-","-","-","-","w"],
    ["w","-","-","-","-","-","-","-","-","-","-","-","-","-","-","-","-","-","-","-","w"],
    ["w","-","-","-","-","-","-","-","-","-","-","-","-","-","-","-","-","-","-","-","w"],
    ["w","p","-","-","-","-","-","-","-","-","-","-","-","-","-","-","-","-","-","-","w"],
    ["w","v","v","v","-","-","-","-","-","-","-","-","-","-","-","-","-","-","-","-","w"],
    ["w","-","-","-","-","-","-","-","-","-","-","-","-","-","-","-","-","-","-","-","w"],
    ["w","-","-","-","-","-","-","-","-","-","-","-","-","-","-","-","-","-","-","-","w"],
    ["w","-","-","v","l","l","l","l","v","-","-","-","-","-","-","-","-","-","-","-","w"],
    ["w","-","-","w","l","l","l","l","w","-","-","-","-","-","-","-","-","-","-","-","w"],
    ["w","-","-","w","l","l","l","l","w","-","-","-","-","-","-","-","-","-","-","c","w"],
    ["w","w","w","w","w","w","w","w","w","w","w","w","w","w","w","w","w","w","w","w","w"]
    ],
    "level_name": "13616",
    "type_name": ["wood","metal","stone"],
    "type_count": [0,2,1],
    "biom": "stone"
  }
]
    